0 0 0 0 0 0 0 0 0 0 0 0 0 39 39 39 0 0 0 0 0 0 39 39 39 39 0 0 0 0 0 0 0 0 0 0 0 0 0 0 0 0 0 0 0 0 0 39 0 0 
0 0 0 0 0 0 0 0 0 0 0 0 0 0 39 40 39 0 0 0 39 39 39 39 0 0 0 0 0 0 0 0 0 0 0 0 0 0 0 0 0 0 0 0 0 0 39 39 0 0 
0 0 0 0 0 0 0 0 0 0 0 0 0 0 39 39 39 39 0 39 39 39 0 0 0 0 0 0 0 0 0 0 0 0 0 0 0 0 0 0 0 0 0 0 0 0 39 39 0 0 
0 0 0 0 0 0 0 0 0 0 0 0 0 0 0 39 39 39 39 39 0 0 0 0 0 0 0 0 0 0 0 0 0 0 0 0 0 0 0 0 0 0 0 0 0 39 39 39 0 0 
0 0 0 0 0 0 0 0 0 0 0 0 0 0 0 0 39 39 39 0 0 0 0 0 0 0 0 0 0 0 0 0 0 0 0 0 0 0 0 0 0 0 0 0 0 39 39 39 0 0 
0 0 0 0 0 16 16 16 16 16 16 0 0 0 39 39 39 0 39 39 0 0 0 0 0 0 0 0 0 0 0 0 0 0 0 0 0 0 0 0 0 0 0 0 39 39 39 0 0 0 
0 0 16 16 16 16 0 0 16 16 16 0 39 39 40 39 0 0 39 39 39 0 0 0 0 0 0 0 0 0 0 0 0 0 0 0 0 0 0 0 0 0 0 0 39 39 39 0 0 0 
38 0 0 16 16 0 16 16 16 0 39 39 39 39 0 0 0 0 0 39 39 0 0 0 0 0 0 0 0 0 0 0 0 0 0 0 0 0 0 0 0 0 0 0 39 39 0 0 0 0 
38 38 0 0 16 16 16 0 39 39 39 39 0 0 0 0 0 0 0 39 39 39 0 0 0 0 0 0 0 0 0 0 0 0 0 0 0 0 0 0 0 0 0 39 39 39 0 0 0 0 
38 38 38 0 0 0 39 39 39 39 0 0 0 0 0 0 0 0 0 0 39 39 0 0 0 0 0 0 0 0 0 0 0 0 0 0 0 0 0 0 0 0 0 39 39 39 0 0 0 0 
0 38 38 0 0 39 39 39 0 0 0 0 0 0 0 0 0 0 0 0 39 39 39 0 0 0 0 0 0 0 0 0 0 0 0 0 0 0 0 0 0 0 0 39 39 0 0 0 0 0 
0 38 38 38 40 39 39 39 39 39 39 39 39 39 39 39 39 39 39 39 39 40 39 40 39 39 39 39 39 39 39 39 39 39 39 39 39 39 39 39 39 39 39 39 39 39 39 39 39 39 
0 39 38 38 38 39 39 39 39 39 39 39 39 39 39 39 39 39 39 39 39 39 39 39 39 39 39 39 39 39 39 39 39 39 39 39 39 0 39 39 39 39 39 39 39 39 40 38 39 39 
39 40 38 38 38 0 0 0 0 0 0 0 0 0 0 0 0 0 0 0 0 0 39 39 0 0 0 0 0 16 16 16 16 16 0 0 0 0 0 0 0 39 39 0 0 0 38 38 0 0 
39 39 0 38 38 38 0 0 0 0 0 0 0 0 0 0 0 0 0 0 0 0 39 39 39 0 0 0 0 16 0 0 16 16 0 0 16 16 16 16 0 39 39 0 0 0 38 38 38 0 
0 0 0 38 38 38 0 0 0 0 0 0 0 0 0 0 0 0 16 0 0 0 0 39 39 39 0 0 0 16 16 16 16 16 16 16 16 0 16 16 39 39 39 0 0 0 38 38 38 0 
0 0 0 0 38 38 38 0 0 0 0 0 0 0 0 0 16 16 16 0 0 0 0 39 40 39 0 0 0 16 16 16 16 0 0 0 0 16 16 0 39 39 0 0 0 0 38 38 38 0 
0 0 0 0 0 38 38 0 0 0 0 0 0 0 0 0 16 16 0 0 16 16 16 0 39 39 39 0 0 16 0 0 16 16 0 0 16 16 0 0 39 39 0 0 0 0 38 38 38 0 
0 0 0 0 0 0 38 38 0 0 0 0 0 0 0 0 16 16 0 0 16 0 16 0 0 39 39 0 0 16 16 0 0 16 16 16 16 0 0 39 39 39 0 0 0 0 38 38 0 0 
0 0 0 0 0 0 38 38 38 0 0 0 0 0 0 16 16 16 0 16 16 0 16 0 0 39 39 39 0 0 16 0 0 0 0 16 0 0 0 40 40 38 0 0 0 0 38 40 0 0 
0 0 0 0 0 0 0 38 38 39 0 0 0 0 0 16 16 16 16 16 0 0 16 0 0 0 39 39 39 0 16 16 0 0 0 0 0 0 0 39 39 0 0 0 0 0 38 38 0 0 
0 0 0 0 0 0 0 0 39 39 0 0 0 0 0 16 16 16 16 16 0 16 16 0 0 0 0 39 39 39 0 16 16 0 0 0 0 0 39 39 0 0 0 0 0 0 38 38 0 0 
0 0 0 0 0 0 0 0 39 39 39 0 0 0 0 16 16 0 16 16 16 16 16 16 16 0 0 39 39 39 0 0 16 0 0 0 0 38 39 38 0 0 0 0 0 0 38 38 0 0 
0 0 0 0 0 0 0 0 0 39 39 39 0 0 0 0 16 16 16 16 16 0 16 0 16 16 0 0 40 39 39 0 16 0 0 0 0 39 39 0 0 0 0 0 0 0 38 38 0 0 
0 0 0 0 0 0 0 0 0 0 39 39 0 0 0 0 16 0 0 0 0 0 16 0 0 16 0 0 39 39 39 39 16 16 0 0 38 39 0 0 0 0 0 0 0 0 38 38 0 0 
0 0 0 0 0 0 0 0 0 0 39 39 39 0 0 0 16 16 0 0 0 0 16 0 0 16 0 0 0 39 39 39 39 16 0 38 39 39 0 0 0 0 0 0 0 0 38 38 0 0 
0 0 16 16 16 0 0 16 16 16 16 39 39 39 0 16 0 16 16 16 16 0 16 16 0 0 0 0 0 39 39 39 39 16 0 38 39 0 0 0 0 0 0 0 0 0 40 38 0 39 
0 0 16 0 16 16 0 16 16 0 16 16 39 39 39 16 16 0 0 0 16 16 16 16 0 0 0 0 0 0 39 39 39 39 38 39 39 0 0 0 0 0 0 0 0 0 38 38 39 39 
0 16 16 0 0 16 16 0 16 16 0 16 0 39 39 0 16 0 0 0 0 0 0 16 16 0 0 0 0 0 0 39 39 39 38 39 0 0 0 0 0 0 0 0 0 0 38 38 38 38 
0 16 0 0 0 0 16 16 0 16 16 16 16 39 39 40 16 16 0 0 0 0 0 0 16 16 0 0 0 0 0 0 39 38 39 39 0 0 0 0 0 0 0 0 0 38 38 39 38 39 
0 16 16 0 0 0 0 16 16 0 16 16 16 0 39 39 39 16 16 0 0 0 0 0 0 0 0 0 0 0 0 0 0 38 39 16 16 0 0 0 0 0 0 0 0 38 38 38 38 16 
0 0 16 16 16 0 0 0 16 0 0 16 16 0 0 39 39 16 16 16 0 0 0 0 0 0 0 0 0 0 0 0 0 39 39 39 16 0 0 0 0 0 0 0 39 38 39 38 38 16 
0 0 0 0 16 0 0 0 0 16 0 16 16 16 0 0 39 39 16 16 0 0 0 0 0 0 16 16 16 16 16 16 38 38 39 39 16 16 0 0 0 0 39 39 39 39 39 38 38 0 
0 0 0 16 0 0 0 0 0 16 16 0 16 16 0 0 39 39 39 16 16 16 16 16 16 16 16 0 0 0 0 38 38 38 39 39 39 16 16 16 0 39 39 39 16 16 39 38 38 0 
38 0 0 16 16 16 0 16 0 0 16 16 16 16 0 0 0 39 39 16 16 0 0 16 16 16 0 0 0 0 0 38 38 16 39 39 39 39 16 16 39 39 39 16 16 16 39 38 38 0 
38 38 0 0 0 16 16 16 16 16 16 16 16 16 0 0 16 39 39 39 16 16 0 0 0 16 16 16 0 0 38 38 16 16 0 39 39 40 39 39 39 39 16 16 16 16 16 38 38 0 
38 38 39 39 0 0 0 0 16 16 16 16 16 16 16 16 16 0 39 39 16 16 16 0 0 16 16 16 0 38 38 38 16 0 0 16 39 39 39 39 16 16 16 16 0 0 16 38 38 0 
0 40 39 39 39 39 0 0 0 0 0 0 0 16 16 16 0 0 39 39 39 16 16 16 16 16 0 0 0 38 38 16 16 0 16 16 39 39 39 39 16 16 16 0 0 0 16 38 38 0 
0 0 39 39 39 39 39 39 0 0 0 0 0 0 16 0 0 16 16 16 40 39 16 0 16 16 16 16 16 40 38 16 16 16 16 38 38 39 39 39 16 16 16 16 0 16 16 38 38 0 
16 16 0 0 0 39 40 39 39 39 0 0 0 0 16 16 16 16 16 16 39 39 39 16 16 16 16 0 38 38 16 16 16 16 39 38 39 16 16 39 39 0 0 16 0 16 16 38 38 0 
16 16 16 0 0 0 0 39 39 39 39 39 0 0 0 16 16 16 16 16 16 39 39 16 16 0 0 0 38 38 16 16 16 39 39 39 16 16 16 39 39 39 0 16 0 16 16 38 38 0 
16 0 16 16 0 0 0 0 0 39 39 39 39 39 0 16 0 16 16 16 16 39 39 39 0 0 0 38 38 38 16 16 39 39 39 16 0 0 0 16 39 40 39 16 0 16 0 38 38 0 
0 0 16 16 16 16 0 0 0 0 39 40 39 39 39 39 16 16 0 0 16 16 40 39 38 0 0 38 38 16 16 39 39 39 16 0 0 16 16 16 0 39 39 39 0 16 0 38 38 0 
0 0 16 0 0 16 16 16 0 0 0 0 39 39 39 39 39 39 16 16 0 16 16 38 38 39 39 39 39 39 39 39 39 16 0 0 16 16 0 0 0 39 39 39 39 39 0 39 38 0 
16 0 16 16 16 16 16 16 16 0 0 0 0 0 16 39 39 39 39 0 0 16 0 39 39 39 39 39 39 39 39 39 16 0 0 0 16 16 16 16 16 16 39 39 39 39 0 39 38 0 
16 16 0 0 0 16 0 16 16 0 0 0 0 0 0 0 16 39 39 39 39 39 39 39 39 39 39 39 39 39 39 39 39 16 16 16 16 16 16 16 16 16 16 39 39 39 39 39 38 0 
0 16 16 16 16 16 0 0 0 0 0 0 0 0 0 0 0 0 0 0 39 39 39 39 40 39 39 39 40 39 39 39 39 39 0 0 0 0 0 0 0 0 0 39 39 39 40 38 38 0 
39 39 39 39 39 39 39 39 39 39 39 39 39 39 39 39 39 39 39 39 39 39 39 39 39 39 39 39 39 39 39 39 39 39 39 39 39 39 39 39 39 39 39 39 39 39 39 39 39 39 
39 39 39 39 39 39 39 40 39 39 39 39 39 39 39 40 39 39 39 39 39 39 39 39 39 39 39 39 39 39 39 39 39 39 39 39 39 39 39 40 39 39 39 39 39 40 39 39 39 39 
39 39 39 39 39 39 39 39 39 39 39 39 39 39 39 39 39 39 39 39 39 39 39 39 39 39 39 39 39 39 39 39 39 39 39 39 39 39 39 39 39 39 39 39 39 39 39 39 39 39 
